...........................
......00000000000000000000.
......00000000000000000000.
......00000000000000000000.
......00000000000000000000.
......00000000000000000000.
......00000000000000000000.
......00000000000000000000.
......00000000000000000000.
......00000000000010000000.
......00000000000000000000.
......00000000000000000000.
......00000000000000000000.
......00000000000100000000.
......00000000000000000000.
......00000000100000000000.
......00000000000000000000.
......00000000000000000000.
......00000000000000000000.
......00000000000000000000.
......00000000000000000000.
      ....................


